11111111111111
1P000000000001
100CAA11111111
10111111111111
10111111111111
100C0E11111111
11111111111111