11111111111111
1P000000000001
100CAA11000001
10111111000001
10111111000001
100C0E11111111
11111111111111