1111111
1P00001
100CAA1
1011111
100C0E1
1111111