111111
1PCC11
111111
1000E1
111111