1111111
1P00001
100C001
1011111
100C0E1
1111111